name = Labyrinth
map_size_blocks= 24x17

amount_of_walls = 1
wall_1 = misc\img\Walls\cobblestone.png

point_image = misc\img\point.png

$Map
111111111111111111111111
100000000001000000100001
101111101101011101001111
100000100100010101010001
101010010111110000000101
101000100100011111101001
101101001000001000110011
1000100100G0G01010010111
101000111100001011000001
101110000001111000111101
100011110100000010000001
101000000101111011110101
101110110100011010010111
101000110101000011010011
101110111101111011011011
10000000000P000000000001
111111111111111111111111
