name = Garden
map_size_blocks= 24x17

amount_of_walls = 3
wall_1 = misc\img\Walls\bush.png
wall_2 = misc\img\Walls\yellow_flower.png
wall_3 = misc\img\Walls\red_flower.png


point_image = misc\img\point.png

$Map
111111111100001111111111
100000000100001000000001
102323230000000023232301
103232320100001032323201
102323200100001003232301
100000001000000100000001
111001110000000011100111
000000000011110000000000
00000000G012310G00000000
000000000011110000000000
111001110000000011100111
100000001000000100000001
103232300100001002323201
102323230100001023232301
103232320000000032323201
100000000100P01000000001
111111111100001111111111

